#..###
..##.#.####
.##.@###..#
##........#
#......#..#
#....#.#..#
..#..#....#
.##.##.#.##
.#......##
.#.....##
.##.....